10 10
4 5
2 2
6 2
OOOOOOOOOO
OOOXXXXXXO
OOOXXXXXXO
OOOXXXXXXO
OOOOOOOOOO
OOOOOOXOOO
OOOXXXXXXO
OOOXXXXXXO
OOOXXXXXXO
OOOOOOOOOO
