20 13
13 9
2 9
17 8
XOOOOOOOXOOOOOOOOOXX
XOOOOOOOOOOOOOOOOOXX
XOOOOOOOOOOOOOOOOOXX
XOOOOOOOOOOOOOOOOOOO
OOOOOOOOXOOOOOOOOOOX
OOOOOOOXXXOOOOOOOOOX
OOOOOOXXXXXOOOOOOOOX
OOOOOOOXXXOOOOOOOOOX
OOOOOOOOXOOOOOOOOOOX
XOOOOOOOOOOOOOOOOOOO
XOOOOOOOOOOOOOOOOOXX
XOOOOOOOOOOOOOOOOOXX
XOOOOOOOOOOOOOOOOOXX
