10 10
1 5
4 1
10 7
OXOOOOXOOO
XOXXOXOXXO
OOOOOOOOOO
OXXOOXXOXO
XOOOXXOOOX
OXOOOOOOOO
XOXXOXOXXO
OOOXOOOOOO
OXOOOOXOOO
XOOOXXOOOX
