90 90
26 11
4 1
90 67 
OXOOOOXOOOOXOOOOXOOOOXOOOOXOOOOXOOOOXOOOOXOOOOXOOOOXOOOOXOOOOXOOOOXOOOOXOOOOXOOOOXOOOOXOOO
XOXXOXOXXOXOXXOXOXXOXOXXOXOXXOXOXXOXOXXOXOXXOXOXXOXOXXOXOXXOXOXXOXOXXOXOXXOXOXXOXOXXOXOXXO
OOOOOOOOOOOOOOOOOOOOOOOOOOOOOOOOOOOOOOOOOOOOOOOOOOOOOOOOOOOOOOOOOOOOOOOOOOOOOOOOOOOOOOOOOO
OXXOOXXOXOOXXOOXXOXOOXXOOXXOXOOXXOOXXOXOOXXOOXXOXOOXXOOXXOXOOXXOOXXOXOOXXOOXXOXOOXXOOXXOXO
XOOOXXOOOXXOOOXXOOOXXOOOXXOOOXXOOOXXOOOXXOOOXXOOOXXOOOXXOOOXXOOOXXOOOXXOOOXXOOOXXOOOXXOOOX
OXOOOOOOOOOXOOOOOOOOOXOOOOOOOOOXOOOOOOOOOXOOOOOOOOOXOOOOOOOOOXOOOOOOOOOXOOOOOOOOOXOOOOOOOO
XOXXOXOXXOXOXXOXOXXOXOXXOXOXXOXOXXOXOXXOXOXXOXOXXOXOXXOXOXXOXOXXOXOXXOXOXXOXOXXOXOXXOXOXXO
OOOXOOOOOOOOOXOOOOOOOOOXOOOOOOOOOXOOOOOOOOOXOOOOOOOOOXOOOOOOOOOXOOOOOOOOOXOOOOOOOOOXOOOOOO
OXOOOOXOOOOXOOOOXOOOOXOOOOXOOOOXOOOOXOOOOXOOOOXOOOOXOOOOXOOOOXOOOOXOOOOXOOOOXOOOOXOOOOXOOO
XOOOXXOOOXXOOOXXOOOXXOOOXXOOOXXOOOXXOOOXXOOOXXOOOXXOOOXXOOOXXOOOXXOOOXXOOOXXOOOXXOOOXXOOOX
OXOOOOXOOOOXOOOOXOOOOXOOOOXOOOOXOOOOXOOOOXOOOOXOOOOXOOOOXOOOOXOOOOXOOOOXOOOOXOOOOXOOOOXOOO
XOXXOXOXXOXOXXOXOXXOXOXXOXOXXOXOXXOXOXXOXOXXOXOXXOXOXXOXOXXOXOXXOXOXXOXOXXOXOXXOXOXXOXOXXO
OOOOOOOOOOOOOOOOOOOOOOOOOOOOOOOOOOOOOOOOOOOOOOOOOOOOOOOOOOOOOOOOOOOOOOOOOOOOOOOOOOOOOOOOOO
OXXOOXXOXOOXXOOXXOXOOXXOOXXOXOOXXOOXXOXOOXXOOXXOXOOXXOOXXOXOOXXOOXXOXOOXXOOXXOXOOXXOOXXOXO
XOOOXXOOOXXOOOXXOOOXXOOOXXOOOXXOOOXXOOOXXOOOXXOOOXXOOOXXOOOXXOOOXXOOOXXOOOXXOOOXXOOOXXOOOX
OXOOOOOOOOOXOOOOOOOOOXOOOOOOOOOXOOOOOOOOOXOOOOOOOOOXOOOOOOOOOXOOOOOOOOOXOOOOOOOOOXOOOOOOOO
XOXXOXOXXOXOXXOXOXXOXOXXOXOXXOXOXXOXOXXOXOXXOXOXXOXOXXOXOXXOXOXXOXOXXOXOXXOXOXXOXOXXOXOXXO
OOOXOOOOOOOOOXOOOOOOOOOXOOOOOOOOOXOOOOOOOOOXOOOOOOOOOXOOOOOOOOOXOOOOOOOOOXOOOOOOOOOXOOOOOO
OXOOOOXOOOOXOOOOXOOOOXOOOOXOOOOXOOOOXOOOOXOOOOXOOOOXOOOOXOOOOXOOOOXOOOOXOOOOXOOOOXOOOOXOOO
XOOOXXOOOXXOOOXXOOOXXOOOXXOOOXXOOOXXOOOXXOOOXXOOOXXOOOXXOOOXXOOOXXOOOXXOOOXXOOOXXOOOXXOOOX
OXOOOOXOOOOXOOOOXOOOOXOOOOXOOOOXOOOOXOOOOXOOOOXOOOOXOOOOXOOOOXOOOOXOOOOXOOOOXOOOOXOOOOXOOO
XOXXOXOXXOXOXXOXOXXOXOXXOXOXXOXOXXOXOXXOXOXXOXOXXOXOXXOXOXXOXOXXOXOXXOXOXXOXOXXOXOXXOXOXXO
OOOOOOOOOOOOOOOOOOOOOOOOOOOOOOOOOOOOOOOOOOOOOOOOOOOOOOOOOOOOOOOOOOOOOOOOOOOOOOOOOOOOOOOOOO
OXXOOXXOXOOXXOOXXOXOOXXOOXXOXOOXXOOXXOXOOXXOOXXOXOOXXOOXXOXOOXXOOXXOXOOXXOOXXOXOOXXOOXXOXO
XOOOXXOOOXXOOOXXOOOXXOOOXXOOOXXOOOXXOOOXXOOOXXOOOXXOOOXXOOOXXOOOXXOOOXXOOOXXOOOXXOOOXXOOOX
OXOOOOOOOOOXOOOOOOOOOXOOOOOOOOOXOOOOOOOOOXOOOOOOOOOXOOOOOOOOOXOOOOOOOOOXOOOOOOOOOXOOOOOOOO
XOXXOXOXXOXOXXOXOXXOXOXXOXOXXOXOXXOXOXXOXOXXOXOXXOXOXXOXOXXOXOXXOXOXXOXOXXOXOXXOXOXXOXOXXO
OOOXOOOOOOOOOXOOOOOOOOOXOOOOOOOOOXOOOOOOOOOXOOOOOOOOOXOOOOOOOOOXOOOOOOOOOXOOOOOOOOOXOOOOOO
OXOOOOXOOOOXOOOOXOOOOXOOOOXOOOOXOOOOXOOOOXOOOOXOOOOXOOOOXOOOOXOOOOXOOOOXOOOOXOOOOXOOOOXOOO
XOOOXXOOOXXOOOXXOOOXXOOOXXOOOXXOOOXXOOOXXOOOXXOOOXXOOOXXOOOXXOOOXXOOOXXOOOXXOOOXXOOOXXOOOX
OXOOOOXOOOOXOOOOXOOOOXOOOOXOOOOXOOOOXOOOOXOOOOXOOOOXOOOOXOOOOXOOOOXOOOOXOOOOXOOOOXOOOOXOOO
XOXXOXOXXOXOXXOXOXXOXOXXOXOXXOXOXXOXOXXOXOXXOXOXXOXOXXOXOXXOXOXXOXOXXOXOXXOXOXXOXOXXOXOXXO
OOOOOOOOOOOOOOOOOOOOOOOOOOOOOOOOOOOOOOOOOOOOOOOOOOOOOOOOOOOOOOOOOOOOOOOOOOOOOOOOOOOOOOOOOO
OXXOOXXOXOOXXOOXXOXOOXXOOXXOXOOXXOOXXOXOOXXOOXXOXOOXXOOXXOXOOXXOOXXOXOOXXOOXXOXOOXXOOXXOXO
XOOOXXOOOXXOOOXXOOOXXOOOXXOOOXXOOOXXOOOXXOOOXXOOOXXOOOXXOOOXXOOOXXOOOXXOOOXXOOOXXOOOXXOOOX
OXOOOOOOOOOXOOOOOOOOOXOOOOOOOOOXOOOOOOOOOXOOOOOOOOOXOOOOOOOOOXOOOOOOOOOXOOOOOOOOOXOOOOOOOO
XOXXOXOXXOXOXXOXOXXOXOXXOXOXXOXOXXOXOXXOXOXXOXOXXOXOXXOXOXXOXOXXOXOXXOXOXXOXOXXOXOXXOXOXXO
OOOXOOOOOOOOOXOOOOOOOOOXOOOOOOOOOXOOOOOOOOOXOOOOOOOOOXOOOOOOOOOXOOOOOOOOOXOOOOOOOOOXOOOOOO
OXOOOOXOOOOXOOOOXOOOOXOOOOXOOOOXOOOOXOOOOXOOOOXOOOOXOOOOXOOOOXOOOOXOOOOXOOOOXOOOOXOOOOXOOO
XOOOXXOOOXXOOOXXOOOXXOOOXXOOOXXOOOXXOOOXXOOOXXOOOXXOOOXXOOOXXOOOXXOOOXXOOOXXOOOXXOOOXXOOOX
OXOOOOXOOOOXOOOOXOOOOXOOOOXOOOOXOOOOXOOOOXOOOOXOOOOXOOOOXOOOOXOOOOXOOOOXOOOOXOOOOXOOOOXOOO
XOXXOXOXXOXOXXOXOXXOXOXXOXOXXOXOXXOXOXXOXOXXOXOXXOXOXXOXOXXOXOXXOXOXXOXOXXOXOXXOXOXXOXOXXO
OOOOOOOOOOOOOOOOOOOOOOOOOOOOOOOOOOOOOOOOOOOOOOOOOOOOOOOOOOOOOOOOOOOOOOOOOOOOOOOOOOOOOOOOOO
OXXOOXXOXOOXXOOXXOXOOXXOOXXOXOOXXOOXXOXOOXXOOXXOXOOXXOOXXOXOOXXOOXXOXOOXXOOXXOXOOXXOOXXOXO
XOOOXXOOOXXOOOXXOOOXXOOOXXOOOXXOOOXXOOOXXOOOXXOOOXXOOOXXOOOXXOOOXXOOOXXOOOXXOOOXXOOOXXOOOX
OXOOOOOOOOOXOOOOOOOOOXOOOOOOOOOXOOOOOOOOOXOOOOOOOOOXOOOOOOOOOXOOOOOOOOOXOOOOOOOOOXOOOOOOOO
XOXXOXOXXOXOXXOXOXXOXOXXOXOXXOXOXXOXOXXOXOXXOXOXXOXOXXOXOXXOXOXXOXOXXOXOXXOXOXXOXOXXOXOXXO
OOOXOOOOOOOOOXOOOOOOOOOXOOOOOOOOOXOOOOOOOOOXOOOOOOOOOXOOOOOOOOOXOOOOOOOOOXOOOOOOOOOXOOOOOO
OXOOOOXOOOOXOOOOXOOOOXOOOOXOOOOXOOOOXOOOOXOOOOXOOOOXOOOOXOOOOXOOOOXOOOOXOOOOXOOOOXOOOOXOOO
XOOOXXOOOXXOOOXXOOOXXOOOXXOOOXXOOOXXOOOXXOOOXXOOOXXOOOXXOOOXXOOOXXOOOXXOOOXXOOOXXOOOXXOOOX
OXOOOOXOOOOXOOOOXOOOOXOOOOXOOOOXOOOOXOOOOXOOOOXOOOOXOOOOXOOOOXOOOOXOOOOXOOOOXOOOOXOOOOXOOO
XOXXOXOXXOXOXXOXOXXOXOXXOXOXXOXOXXOXOXXOXOXXOXOXXOXOXXOXOXXOXOXXOXOXXOXOXXOXOXXOXOXXOXOXXO
OOOOOOOOOOOOOOOOOOOOOOOOOOOOOOOOOOOOOOOOOOOOOOOOOOOOOOOOOOOOOOOOOOOOOOOOOOOOOOOOOOOOOOOOOO
OXXOOXXOXOOXXOOXXOXOOXXOOXXOXOOXXOOXXOXOOXXOOXXOXOOXXOOXXOXOOXXOOXXOXOOXXOOXXOXOOXXOOXXOXO
XOOOXXOOOXXOOOXXOOOXXOOOXXOOOXXOOOXXOOOXXOOOXXOOOXXOOOXXOOOXXOOOXXOOOXXOOOXXOOOXXOOOXXOOOX
OXOOOOOOOOOXOOOOOOOOOXOOOOOOOOOXOOOOOOOOOXOOOOOOOOOXOOOOOOOOOXOOOOOOOOOXOOOOOOOOOXOOOOOOOO
XOXXOXOXXOXOXXOXOXXOXOXXOXOXXOXOXXOXOXXOXOXXOXOXXOXOXXOXOXXOXOXXOXOXXOXOXXOXOXXOXOXXOXOXXO
OOOXOOOOOOOOOXOOOOOOOOOXOOOOOOOOOXOOOOOOOOOXOOOOOOOOOXOOOOOOOOOXOOOOOOOOOXOOOOOOOOOXOOOOOO
OXOOOOXOOOOXOOOOXOOOOXOOOOXOOOOXOOOOXOOOOXOOOOXOOOOXOOOOXOOOOXOOOOXOOOOXOOOOXOOOOXOOOOXOOO
XOOOXXOOOXXOOOXXOOOXXOOOXXOOOXXOOOXXOOOXXOOOXXOOOXXOOOXXOOOXXOOOXXOOOXXOOOXXOOOXXOOOXXOOOX
OXOOOOXOOOOXOOOOXOOOOXOOOOXOOOOXOOOOXOOOOXOOOOXOOOOXOOOOXOOOOXOOOOXOOOOXOOOOXOOOOXOOOOXOOO
XOXXOXOXXOXOXXOXOXXOXOXXOXOXXOXOXXOXOXXOXOXXOXOXXOXOXXOXOXXOXOXXOXOXXOXOXXOXOXXOXOXXOXOXXO
OOOOOOOOOOOOOOOOOOOOOOOOOOOOOOOOOOOOOOOOOOOOOOOOOOOOOOOOOOOOOOOOOOOOOOOOOOOOOOOOOOOOOOOOOO
OXXOOXXOXOOXXOOXXOXOOXXOOXXOXOOXXOOXXOXOOXXOOXXOXOOXXOOXXOXOOXXOOXXOXOOXXOOXXOXOOXXOOXXOXO
XOOOXXOOOXXOOOXXOOOXXOOOXXOOOXXOOOXXOOOXXOOOXXOOOXXOOOXXOOOXXOOOXXOOOXXOOOXXOOOXXOOOXXOOOX
OXOOOOOOOOOXOOOOOOOOOXOOOOOOOOOXOOOOOOOOOXOOOOOOOOOXOOOOOOOOOXOOOOOOOOOXOOOOOOOOOXOOOOOOOO
XOXXOXOXXOXOXXOXOXXOXOXXOXOXXOXOXXOXOXXOXOXXOXOXXOXOXXOXOXXOXOXXOXOXXOXOXXOXOXXOXOXXOXOXXO
OOOXOOOOOOOOOXOOOOOOOOOXOOOOOOOOOXOOOOOOOOOXOOOOOOOOOXOOOOOOOOOXOOOOOOOOOXOOOOOOOOOXOOOOOO
OXOOOOXOOOOXOOOOXOOOOXOOOOXOOOOXOOOOXOOOOXOOOOXOOOOXOOOOXOOOOXOOOOXOOOOXOOOOXOOOOXOOOOXOOO
XOOOXXOOOXXOOOXXOOOXXOOOXXOOOXXOOOXXOOOXXOOOXXOOOXXOOOXXOOOXXOOOXXOOOXXOOOXXOOOXXOOOXXOOOX
OXOOOOXOOOOXOOOOXOOOOXOOOOXOOOOXOOOOXOOOOXOOOOXOOOOXOOOOXOOOOXOOOOXOOOOXOOOOXOOOOXOOOOXOOO
XOXXOXOXXOXOXXOXOXXOXOXXOXOXXOXOXXOXOXXOXOXXOXOXXOXOXXOXOXXOXOXXOXOXXOXOXXOXOXXOXOXXOXOXXO
OOOOOOOOOOOOOOOOOOOOOOOOOOOOOOOOOOOOOOOOOOOOOOOOOOOOOOOOOOOOOOOOOOOOOOOOOOOOOOOOOOOOOOOOOO
OXXOOXXOXOOXXOOXXOXOOXXOOXXOXOOXXOOXXOXOOXXOOXXOXOOXXOOXXOXOOXXOOXXOXOOXXOOXXOXOOXXOOXXOXO
XOOOXXOOOXXOOOXXOOOXXOOOXXOOOXXOOOXXOOOXXOOOXXOOOXXOOOXXOOOXXOOOXXOOOXXOOOXXOOOXXOOOXXOOOX
OXOOOOOOOOOXOOOOOOOOOXOOOOOOOOOXOOOOOOOOOXOOOOOOOOOXOOOOOOOOOXOOOOOOOOOXOOOOOOOOOXOOOOOOOO
XOXXOXOXXOXOXXOXOXXOXOXXOXOXXOXOXXOXOXXOXOXXOXOXXOXOXXOXOXXOXOXXOXOXXOXOXXOXOXXOXOXXOXOXXO
OOOXOOOOOOOOOXOOOOOOOOOXOOOOOOOOOXOOOOOOOOOXOOOOOOOOOXOOOOOOOOOXOOOOOOOOOXOOOOOOOOOXOOOOOO
OXOOOOXOOOOXOOOOXOOOOXOOOOXOOOOXOOOOXOOOOXOOOOXOOOOXOOOOXOOOOXOOOOXOOOOXOOOOXOOOOXOOOOXOOO
XOOOXXOOOXXOOOXXOOOXXOOOXXOOOXXOOOXXOOOXXOOOXXOOOXXOOOXXOOOXXOOOXXOOOXXOOOXXOOOXXOOOXXOOOX
OXOOOOXOOOOXOOOOXOOOOXOOOOXOOOOXOOOOXOOOOXOOOOXOOOOXOOOOXOOOOXOOOOXOOOOXOOOOXOOOOXOOOOXOOO
XOXXOXOXXOXOXXOXOXXOXOXXOXOXXOXOXXOXOXXOXOXXOXOXXOXOXXOXOXXOXOXXOXOXXOXOXXOXOXXOXOXXOXOXXO
OOOOOOOOOOOOOOOOOOOOOOOOOOOOOOOOOOOOOOOOOOOOOOOOOOOOOOOOOOOOOOOOOOOOOOOOOOOOOOOOOOOOOOOOOO
OXXOOXXOXOOXXOOXXOXOOXXOOXXOXOOXXOOXXOXOOXXOOXXOXOOXXOOXXOXOOXXOOXXOXOOXXOOXXOXOOXXOOXXOXO
XOOOXXOOOXXOOOXXOOOXXOOOXXOOOXXOOOXXOOOXXOOOXXOOOXXOOOXXOOOXXOOOXXOOOXXOOOXXOOOXXOOOXXOOOX
OXOOOOOOOOOXOOOOOOOOOXOOOOOOOOOXOOOOOOOOOXOOOOOOOOOXOOOOOOOOOXOOOOOOOOOXOOOOOOOOOXOOOOOOOO
XOXXOXOXXOXOXXOXOXXOXOXXOXOXXOXOXXOXOXXOXOXXOXOXXOXOXXOXOXXOXOXXOXOXXOXOXXOXOXXOXOXXOXOXXO
OOOXOOOOOOOOOXOOOOOOOOOXOOOOOOOOOXOOOOOOOOOXOOOOOOOOOXOOOOOOOOOXOOOOOOOOOXOOOOOOOOOXOOOOOO
OXOOOOXOOOOXOOOOXOOOOXOOOOXOOOOXOOOOXOOOOXOOOOXOOOOXOOOOXOOOOXOOOOXOOOOXOOOOXOOOOXOOOOXOOO
XOOOXXOOOXXOOOXXOOOXXOOOXXOOOXXOOOXXOOOXXOOOXXOOOXXOOOXXOOOXXOOOXXOOOXXOOOXXOOOXXOOOXXOOOX
