30 30
7 20
4 1
30 4
OXOOOOXOOOOXOOOOXOOOOXOOOOXOOO
XOXXOXOXXOXOXXOXOXXOXOXXOXOXXO
OOOOOOOOOOOOOOOOOOOOOOOOOOOOOO
OXXOOXXOXOOXXOOXXOXOOXXOOXXOXO
XOOOXXOOOXXOOOXXOOOXXOOOXXOOOX
OXOOOOOOOOOXOOOOOOOOOXOOOOOOOO
XOXXOXOXXOXOXXOXOXXOXOXXOXOXXO
OOOXOOOOOOOOOXOOOOOOOOOXOOOOOO
OXOOOOXOOOOXOOOOXOOOOXOOOOXOOO
XOOOXXOOOXXOOOXXOOOXXOOOXXOOOX
OXOOOOXOOOOXOOOOXOOOOXOOOOXOOO
XOXXOXOXXOXOXXOXOXXOXOXXOXOXXO
OOOOOOOOOOOOOOOOOOOOOOOOOOOOOO
OXXOOXXOXOOXXOOXXOXOOXXOOXXOXO
XOOOXXOOOXXOOOXXOOOXXOOOXXOOOX
OXOOOOOOOOOXOOOOOOOOOXOOOOOOOO
XOXXOXOXXOXOXXOXOXXOXOXXOXOXXO
OOOXOOOOOOOOOXOOOOOOOOOXOOOOOO
OXOOOOXOOOOXOOOOXOOOOXOOOOXOOO
XOOOXXOOOXXOOOXXOOOXXOOOXXOOOX
OXOOOOXOOOOXOOOOXOOOOXOOOOXOOO
XOXXOXOXXOXOXXOXOXXOXOXXOXOXXO
OOOOOOOOOOOOOOOOOOOOOOOOOOOOOO
OXXOOXXOXOOXXOOXXOXOOXXOOXXOXO
XOOOXXOOOXXOOOXXOOOXXOOOXXOOOX
OXOOOOOOOOOXOOOOOOOOOXOOOOOOOO
XOXXOXOXXOXOXXOXOXXOXOXXOXOXXO
OOOXOOOOOOOOOXOOOOOOOOOXOOOOOO
OXOOOOXOOOOXOOOOXOOOOXOOOOXOOO
XOOOXXOOOXXOOOXXOOOXXOOOXXOOOX
