20 13
6 1
2 1
17 8
XOOOXOOOXOOOOOXOOOXX
XXOOOXOOOOOOOOOXOOXX
XOXOOOXOOOOOXOOXOOXX
XOOXOOOXOOOXOXOOOOOO
OOOOXOOOXOXOOXOXOOOX
OOOOOOOXXXOOOOOXOOOX
OOOXXXXXXXXOOOOXOOOX
OXOOOOOXXXOOOOOOOOOX
OOXOOOOOXOOOOOOOOOOX
XOOOOOOOOOOOOOOOOOOO
XOOOXOOOOOOOXOOOOOXX
XOOOOOXOOXOOOOOOOOXX
XOOOOOOOOOOOOOOOOOXX
