30 13
6 1
2 1
21 8
XOOOXOOOXOOOOOXOOOXXOOXOOOOOXO
XXOOOXOOOXOOOOOXOOXXOXOOOOOXOO
XOXOOOXOOOOOXOOXOOXXXOOOOOXOOO
XOOXOOOXOOOXOXOOOOOOOOOOOOOOOO
OOOOXOOOXOXOOXOXOOOXOOOOOOOOOO
OOOOOOOXXXOOOOOXOOOXOOOXOOOOOO
OOOXXOXXXXXOOOOXOOOXXOOOXOOOOO
OXOOOOOXXXOOOOOOOOOXOXOOOXOOOO
OOXOOOOOXXOOOOOOOOOXOOXOOOOOOO
XOOOOOXOOOOOOOOOOOOXOOOXOOOOOO
XOOOXOOOOOOOXOOOOOXXOXOOXOOOOO
XOOOOOXOOXOOOOOOOOXXOOXOOOOOOO
XOOOOOOOOOOOOOOOOOXXOOOOOOOOOO
