50 20
6 1
2 1
50 1
XOOOXOOOXOOOOOXOOOXXOOXOOOOOXOOXOOOOOOOOXXOXOXXOOO
XXOOOXOOOXOOOOOXOOXXOXOOOOOXOXOOXXOXOOOOXXOOOXXOXO
XOXOOOXOOOOOXOOXOOXXXOOOOOXOXOOOOOOOXOOOXXOXOXXOXO
XOOXOOOXOOOXOXOOOOOOOOOOOOOOOOOOOXOOOOOOXXOXOXXOXO
OOOOXOOOXOXOOXOXOOOXOOOOOOOOOOOOOOXOOXOOXXOXOXXOXO
OOOOOOOXXXOOOOOXOOOXOOOXOOOOOOOOOOOOOOOOXXOXOXXOXO
OOOXXOXXXXXOOOOXOOOXXOOOXOOOOOOXOXOXOOOOXXOXOXXOXO
OXOOOOOXXXOOOOOOOOOXOXOOOXOOOOXOOOXOOOOOXXOXOXXOXO
OOXOOOXOXXOOOOOOOOOXOOXOOOOOOXOOOOOXOOOOXXOXOXXOXO
XOOOOOXOOOOOOOOOOOOXOOOXOOOOXOOOOOOOOOOOXXOXOXXOXO
XOOOXOOOOOOOXOOOOOXXOXOOXXXXXOOOXOOOXOOOXXOXOXXOXO
XOOOOOXOOXOOOOOOOOXXOOXOOOOOOOOOOXOOOXOOXXOXOOOOXO
XOOOOOOOOOOOOOOOOOXXOOOOOOOOOOOOOOXOOOOOXXOXOXXOXO
XOOOXOOOXOOOOOXOOOXXOOXOOOOOXOOOOOOOOOOOXXOXOXXOXO
XXOOOXOOOXOOOOOXOOXXOXOOOOOXXOXOXOOXOOXOXXOXOXXOXO
XOXOOOXOOOOOXOOXOOXXXOOOOOXOOOOOOXOOOOOOXXOXOXXOXO
XOOXOOOXOOOXOXOOOOOXOOOOOOOOOOOXOOOOOOOOXXOXOXXOXO
OOOOXOOOXOXOOXOXOOOXOOXOXXOOXXXOOOOXOOOOXXOXOXXOOO
OOOOOOOXXXOOOOOXOOOXOOOXOOOOXOOOOOOOXOOOOOOXOXXOXO
OOOXXOXXXXXOOOOXOOOXXOOOXOOOOOOOXOXXOOOOXXOXOXXOXO
